8 10 4
1111011111
1011011101
1000000001
1110111111
1010100011
1010001011
1001111001
1011111111