8 10 4
1111011101
1011011100
1000000001
1101111111
1101100011
0000001011
1101111001
1111111101
