10 30 12
111111111111011111111111111111
100011111111011100000000111111
111011111111000001111110111111
111000011000011111110000111111
111111011111011111110111111111
111111000000000000111111111111
111110011111011110111000011111
111110111111011110111011011111
110000111111011110000011000111
111111111111111111111111110111
